      11111
     1000001
     100S001
     1000001
     1000001
     1000001
      11111
