





NO textures/north.png


SO                                     ./textures/south.png

WE ./textures/west.png



EA ./textures/east.png


F 0, 0, 0
C                       68                       ,                         200, 120

11111111111111111111111111111111111111111111111111111111111111111111111111111111
10000000000000000000000000000000000000000000000000000000000000000000000000000001
10000000000000000000000000000000000000000000000000000000000000000000000000000001
10000000000000000000000000000000000000000000000000000000000000000000000000000001
10000000000000000000000000000000000000000000000000000000000000000000000000000001
10000000000000000000000000000000000000000000000000000000000000000000000000000001
10000000000000000000000000000000000000000000000000000000000000000000000000000001
10000000000000000000000000000000000000000000000000000000000000000000000000000001
10000000000000000000000000000000000000000000000000000000000000000000000000000001
10000000000000000000000000000000000000000000000000000000000000000000000000000000111111111111111111111111111111111111111111111111111111111111111
100000000000000000000000000000000000000000000000000000000000000000000000000000000000000000000000000000000000000000000000000000000000000000000001
100000000000000000000000000000000000000000000000000000000000000000000000000000000000000000000000000000000000000000000000000000000000000000000001
100000000000000000000000000000000000000000000000000000000000000000000000000000000000000000000000000000000000000000000000000000000000000000000001
1000000000000000000000000000000000000000000000000000000000000000000000000N0000000000000000000000000000000000000000000000000000000000000000000001
100000000000000000000000000000000000000000000000000000000000000000000000000000000000000000000000000000000000000000000000000000000000000000000001
111111111111111111111111111111111111111111111111111111111111111111111111111111110000000000000000000000000000000000000000000000000000000000000001
                                                                                1000000000000000000000000000000000000000000000000000000000000001
                                                                                1000000000000000000000000000000000000000000000000000000000000001
                                                                                1000000000000000000000000000000000000000000000000000000000000001
                                                                                1000000000000000000000000000000000000000000000000000000000000001
                                                                                1000000000000000000000000000000000000000000000000000000000000001
                                                                                1000000000000000000000000000000000000000000000000000000000000001
                                                                                 11111111111111111111111111111111111111111111111111111111111111