





NO ./textures/north.png





SO ./textures/south.png





EA ./textures/east.png
WE ./textures/west.png

F  
C 0, 118, 186


   11111111111111111111
   1N000000000000000001
   10000000000000000001
   10000000000000000001
   10000000000000000001
   10000000000000000001
   11111111111111111111
     
     
